9 16 22
######################
#                   B#
#                    #
#                   V#
#                    #
#                    #
#                    #
#            G       #
#         G        V #
#                    #
#                    #
#                    #
#                    #
#                    #
#  B    V    V    V  #
######################