2 16 22
######################
#  z  v  z  v  z  v V#
# #  # #    ## #  #  #
#c  #   #  #    #   z#
#  #  x  ##  x   #   #
#z #   z    z    #  x#
#   #   c  c    x    #
#x#  #   vv    #  x c#
#         G          #
#c     # zzz #      v#
# #     #   #     #  #
#v z x   # #   x v  z#
#         #          #
#z#  z  x  c  v z # x#
#V z  x  c  v  z  x V#
######################