6 16 22
######################
#                    #
#  ######    ######  #
#  #              #  #
#  #              #  #
#  #              #  #
#       xzcxv        #
#       c  Gv        #
#       zcxvz        #
#  #              #  #
#  #              #  #
#  #              #  #
#  #              #  #
#  ######  B ######  #
#   V     V      V   #
######################