8 16 22
######################
#   #   #   #   # V  #
#                    #
#                    #
#   #  #    #    #   #
#         G          #
#   #     #     #    #
#         G          #
#  #  #     #    #   #
#                    #
#  #  V   #     V  # #
#                    #
#   #     #   #      #
#                    #
# B   #     #    #   #
######################