1 16 22
######################
#  z  v  z  v  z  v V#
# #  # #    ## #  #  #
#                    #
#  #  x  ##  x   #   #
#z #   z    z    #  x#
#   #   c  c    x    #
#                    #
#                    #
#c     # zzz #     ###
# #     #   #     #  #
#                    #
#         #          #
#  #    #   #     #  #
#V #    #   #     # V#
######################
