5 16 22
######################
#                  B #
#                    #
#       #z  v#       #
#       #c  x#       #
#       #x  z#       #
#    ####v  c####    #
#                    #
#     G        G     #
#    ####c  v####    #
#       #z  c#       #
#       #x  x#       #
#       #v  z#       #
#   V             V  #
#          B         #
######################