4 16 22
######################
#                    #
#  #  #  #xv#  #  #  #
#     x              #
#  #  #  #  #vx#  #  #
#                    #
#  #  #  #  #  #  #  #
#     v    Gz      B #
#  #  #  #  #  #  #  #
#        c       V   #
#  #  #  #vx#  #  #  #
#                    #
#  #  #  #  #  #  #  #
#  #  c  #  x  #  z  #
#     B          V   #
######################