7 16 22
######################
#         #          #
#       z   v        #
#      #  G  #       #
#     #       #      #
#    #    G    #     #
#   #    c c    #    #
#     #       #      #
#     x       x      #
#  V  v       z   V  #
#     #       #      #
#     # V     #      #
#     #      V#      #
#     ###zxc###      #
#  z            B x  #
######################